alors	ADV	alors
au	PRP:det	au
aucuns	PRO:IND	aucun
aussi	ADV	aussi
autre	ADJ	autre
avant	PRP	avant
avec	PRP	avec
avoir	VER:infi	avoir
bon	ADV	bon
car	KON	car
chaque	PRO:IND	chaque
ci	ADV	ci
comme	ADV	comme
comment	ADV	comment
dans	PRP	dans
du	PRP:det	du
dedans	ADV	dedans
dehors	ADV	dehors
depuis	PRP	depuis
devoir	VER:infi	devoir
donc	ADV	donc
dos	NOM	dos
début	NOM	début
en	PRP	en
encore	ADV	encore
essai	NOM	essai
et	KON	et
eu	VER:pper	avoir
faire	VER:infi	faire
fois	NOM	foi|fois
hors	PRP	hors
ici	ADV	ici
juste	ADJ	juste
là	ADV	là
maintenant	ADV	maintenant
mais	KON	mais
moins	ADV	moins
mot	NOM	mot
même	ADJ	même
ni	KON	ni
ou	KON	ou
où	PRO:REL	où
par	PRP	par
parce	KON	parce
pas	ADV	pas
pouvoir	VER:infi	pouvoir
peu	ADV	peu
plupart	NOM	plupart
pour	PRP	pour
pourquoi	NOM	pourquoi
quand	KON	quand
sans	PRP	sans
seulement	ADV	seulement
si	ADV	si
sous	PRP	sous
sujet	ADJ	sujet
sur	PRP	sur
tandis	KON	tandis
tellement	ADV	tellement
tels	PRO:DEM	tel
tous	NOM	tous
tout	ADV	tout
trop	ADV	trop
très	ADV	très
voir	VER:infi	voir
aller	VER:infi	aller
ça	PRO:DEM	cela
état	NOM	état
a	VER:pres	avoir
abord	NOM	abord
absolument	ADV	absolument
afin	KON	afin
ah	INT	ah
ai	VER:pres	avoir
aie	VER:impe	avoir
aient	VER:subp	avoir
aies	VER:subp	avoir
ailleurs	ADV	ailleurs
ainsi	KON	ainsi
ait	VER:subp	avoir
allaient	VER:impf	aller
allo	NOM	allo
allons	VER:pres	aller
allô	INT	allô
alors	ADV	alors
anterieur	VER:cond	anterieur
anterieure	ADJ	anterieure
anterieures	VER:futu	anterieures
apres	NOM	apres
après	ADV	après
as	VER:pres	avoir
assez	ADV	assez
attendu	VER:pper	attendre
au	PRP:det	au
aucun	PRO:IND	aucun
aucune	PRO:IND	aucun
aucuns	PRO:IND	aucun
aujourd	VER:pres	aujourd
aujourd'hui	ADV	aujourd'hui
aupres	NOM	aupres
auquel	PRO:REL	auquel
aura	VER:futu	avoir
aurai	VER:futu	avoir
auraient	VER:cond	avoir
aurais	VER:cond	avoir
aurait	VER:cond	avoir
auras	NOM	aura
aurez	VER:futu	avoir
auriez	VER:cond	avoir
aurions	VER:cond	avoir
aurons	VER:futu	avoir
auront	VER:futu	avoir
aussi	ADV	aussi
autre	ADJ	autre
autrefois	ADV	autrefois
autrement	ADV	autrement
autres	ADJ	autre
autrui	NOM	autrui
aux	PRP:det	au
auxquelles	PRO:REL	auquel
auxquels	PRO:REL	auquel
avaient	VER:impf	avoir
avais	VER:impf	avoir
avait	VER:impf	avoir
avant	PRP	avant
avec	ADV	avec
avez	VER:pres	avoir
aviez	VER:impf	avoir
avions	VER:impf	avoir
avoir	VER:infi	avoir
avons	VER:pres	avoir
ayant	VER:ppre	avoir
ayez	VER:impe	avoir
ayons	VER:impe	avoir
b	VER:simp	b
bah	INT	bah
bas	ADJ	bas
basee	NOM	basee
bat	VER:pres	battre
beau	ADJ	beau
beaucoup	ADV	beaucoup
bien	ADV	bien
bigre	NOM	bigre
bon	ADJ	bon
boum	NOM	boum
bravo	INT	bravo
brrr	NOM	brrr
c	VER:subi	c
car	KON	car
ce	PRO:DEM	ce
ceci	PRO:DEM	ceci
cela	PRO:DEM	cela
celle	PRO:DEM	celui
celle	PRO:DEM	celui
-ci	ADV	-ci
celle-là	ADJ	celle-là
celles	PRO:DEM	celui
celles	PRO:DEM	celui
-ci	ADV	-ci
celles-là	ADJ	celles-là
celui	PRO:DEM	celui
celui	PRO:DEM	celui
-ci	ADV	-ci
celui-là	ABR	celui-là
celà	ABR	celà
cent	NUM	cent
cependant	ADV	cependant
certain	PRO:IND	certain
certaine	ADJ	certain
certaines	ADJ	certain
certains	PRO:IND	certain
certes	ADV	certes
ces	PRO:DEM	ce
cet	PRO:DEM	ce
cette	PRO:DEM	ce
ceux	PRO:DEM	celui
ceux	PRO:DEM	celui
-ci	ADV	-ci
ceux-là	ADJ	ceux-là
chacun	PRO:IND	chacun
chacune	PRO:IND	chacun
chaque	PRO:IND	chaque
cher	ADV	cher
chers	ADJ	cher
chez	PRP	chez
chiche	ADJ	chiche
chut	NOM	chut
chère	ADJ	cher
chères	VER:subp	chérer
ci	ADV	ci
cinq	NUM	cinq
cinquantaine	NOM	cinquantaine
cinquante	ADJ	cinquante
cinquantième	ADJ	cinquantième
cinquième	NOM	cinquième
clac	INT	clac
clic	NOM	clic
combien	ADV	combien
comme	ADV	comme
comment	ADV	comment
comparable	ADJ	comparable
comparables	ADJ	comparable
compris	VER:pper	comprendre
concernant	PRP	concernant
contre	NOM	contre
couic	INT	couic
crac	NOM	crac
d	VER:subi	d
da	INT	da
dans	PRP	dans
de	PRP	de
debout	ADV	debout
dedans	ADV	dedans
dehors	PRP	dehors
deja	NOM	deja
delà	ADV	delà
depuis	PRP	depuis
dernier	ADJ	dernier
derniere	NOM	derniere
derriere	NOM	derriere
derrière	PRP	derrière
des	PRP:det	du
desormais	NOM	desormais
desquelles	PRO:REL	duquel
desquels	PRO:REL	duquel
dessous	ADV	dessous
dessus	ADV	dessus
deux	NUM	deux
deuxième	NOM	deuxième
deuxièmement	ADV	deuxièmement
devant	ADV	devant
devers	PRP	devers
devra	VER:futu	devoir
devrait	VER:cond	devoir
different	VER:simp	different
differentes	ADJ	differentes
differents	NOM	differents
différent	ADJ	différent
différente	ADJ	différent
différentes	ADJ	différent
différents	ADJ	différent
dire	NOM	dire
directe	ADJ	direct
directement	ADV	directement
dit	VER:pres	dire
dite	VER:pper	dire
dits	VER:pper	dire
divers	ADJ	divers
diverse	ADJ	divers
diverses	ADJ	divers
dix	NOM	dix
dix-huit	NUM	dix-huit
dix-neuf	NUM	dix-neuf
dix-sept	NUM	dix-sept
dixième	NOM	dixième
doit	VER:pres	devoir
doivent	VER:pres	devoir
donc	ADV	donc
dont	PRO:REL	dont
dos	NOM	dos
douze	NUM	douze
douzième	ADJ	douzième
dring	NOM	dring
droite	ADJ	droit
du	PRP:det	du
duquel	PRO:REL	duquel
durant	PRP	durant
dès	PRP	dès
début	NOM	début
désormais	ADV	désormais
e	VER:subi	e
effet	NOM	effet
egale	NOM	egale
egalement	NOM	egalement
egales	NOM	egales
eh	INT	eh
elle	PRO:PER	elle
elle-même	PRO:PER	elle-même
elles	PRO:PER	elle
elles-mêmes	PRO:PER	elle-même
en	PRP	en
encore	ADV	encore
enfin	ADV	enfin
entre	PRP	entre
envers	PRP	envers
environ	ADV	environ
es	VER:pres	être
essai	NOM	essai
est	VER:pres	être
et	KON	et
etant	VER:ppre	etant
etc	ABR	etc
etre	VER:futu	etre
eu	VER:pper	avoir
eue	VER:pper	avoir
eues	VER:pper	avoir
euh	INT	euh
eurent	VER:simp	avoir
eus	VER:pper	avoir
eusse	VER:subi	avoir
eussent	VER:subi	avoir
eusses	VER:subi	avoir
eussiez	VER:subi	avoir
eussions	VER:subi	avoir
eut	VER:simp	avoir
eux	PRO:PER	eux
eux-mêmes	PRO:PER	lui-même
exactement	ADV	exactement
excepté	VER:pper	excepter
extenso	ADV	extenso
exterieur	ADJ	exterieur
eûmes	VER:simp	avoir
eût	VER:subi	avoir
eûtes	VER:simp	avoir
f	VER:pper	f
fais	VER:pres	faire
faisaient	VER:impf	faire
faisant	VER:ppre	faire
fait	VER:pper	faire
faites	VER:pres	faire
façon	NOM	façon
feront	VER:futu	faire
fi	NOM	fi
flac	INT	flac
floc	NOM	floc
fois	NOM	foi|fois
font	VER:pres	faire
force	NOM	force
furent	VER:simp	être
fus	VER:simp	être
fusse	VER:subi	être
fussent	VER:subi	être
fusses	VER:subi	être
fussiez	VER:subi	être
fussions	VER:subi	être
fut	VER:simp	être
fûmes	VER:simp	être
fût	NOM	fût
fûtes	VER:simp	être
g	VER:pper	g
gens	NOM	gens
h	ABR	heure
ha	ABR	ha
haut	NOM	haut
hein	INT	hein
hem	INT	hem
hep	INT	hep
hi	INT	hi
ho	INT	ho
holà	NOM	holà
hop	INT	hop
hormis	PRP	hormis
hors	PRP	hors
hou	INT	hou
houp	INT	houp
hue	VER:impe	huer
hui	VER:pper	hui
huit	NUM	huit
huitième	NOM	huitième
hum	INT	hum
hurrah	NOM	hurrah
hé	INT	hé
hélas	VER:simp	héler
i	VER:pper	i
ici	ADV	ici
il	PRO:PER	il
ils	PRO:PER	il
importe	VER:pres	importer
j	NOM	j
je	PRO:PER	je
jusqu	NOM	jusqu
jusque	PRP	jusque
juste	ADJ	juste
k	NOM	k
l	VER:subi	l
la	DET:ART	le
laisser	VER:infi	laisser
laquelle	PRO:REL	lequel
las	NOM	la
le	PRO:PER	le
lequel	PRO:REL	lequel
les	PRO:PER	la|le
lesquelles	PRO:REL	lequel
lesquels	PRO:REL	lequel
leur	PRO:PER	lui
leurs	DET:POS	leur
longtemps	NOM	longtemps
lors	ADV	lors
lorsque	KON	lorsque
lui	PRO:PER	lui
lui-meme	VER:subp	lui-meme
lui-même	PRO:PER	lui-même
là	ADV	là
lès	PRP	lès
m	VER:infi	m
ma	DET:POS	mon
maint	PRO:IND	maint
maintenant	ADV	maintenant
mais	KON	mais
malgre	ADJ	malgre
malgré	PRP	malgré
maximale	ADJ	maximal
me	PRO:PER	me
meme	VER:subp	meme
memes	ADJ	memes
merci	NOM	merci
mes	DET:POS	mon
mien	PRO:POS	mien
mienne	PRO:POS	mien
miennes	PRO:POS	mien
miens	PRO:POS	mien
mille	NUM	mille
mince	ADJ	mince
mine	NOM	mine
minimale	ADJ	minimal
moi	PRO:PER	moi
moi-meme	VER:pres	moi-meme
moi-même	PRO:PER	moi-même
moindres	ADJ	moindre
moins	ADV	moins
mon	DET:POS	mon
mot	NOM	mot
moyennant	PRP	moyennant
multiple	NOM	multiple
multiples	ADJ	multiple
même	ADV	même
mêmes	ADJ	même
n	VER:futu	n
na	INT	na
naturel	NOM	naturel
naturelle	ADJ	naturel
naturelles	ADJ	naturel
ne	ADV	ne
neanmoins	NOM	neanmoins
necessaire	ADJ	necessaire
necessairement	NOM	necessairement
neuf	ADJ	neuf
neuvième	ADJ	neuvième
ni	KON	ni
nombreuses	ADJ	nombreux
nombreux	ADJ	nombreux
nommés	VER:pper	nommer
non	ADV	non
nos	DET:POS	notre
notamment	ADV	notamment
notre	DET:POS	notre
nous	PRO:PER	nous
nous-mêmes	PRO:PER	nous-mêmes
nouveau	ADJ	nouveau
nouveaux	NOM	nouveau
nul	ADJ	nul
néanmoins	ADV	néanmoins
nôtre	PRO:POS	nôtre
nôtres	PRO:POS	nôtre
o	VER:simp	o
oh	INT	oh
ohé	INT	ohé
ollé	INT	ollé
olé	INT	olé
on	PRO:PER	on
ont	VER:pres	avoir
onze	NUM	onze
onzième	NOM	onzième
ore	KON	ore
ou	KON	ou
ouf	INT	ouf
ouias	NOM	ouias
oust	INT	oust
ouste	INT	ouste
outre	ADV	outre
ouvert	VER:pper	ouvrir
ouverte	ADJ	ouvert
ouverts	ADJ	ouvert
où	PRO:REL	où
p	NOM	p
paf	ADJ	paf
pan	NOM	pan
par	PRP	par
parce	KON	parce
parfois	ADV	parfois
parle	VER:pres	parler
parlent	VER:pres	parler
parler	VER:infi	parler
parmi	PRP	parmi
parole	NOM	parole
parseme	ADJ	parseme
partant	KON	partant
particulier	ADJ	particulier
particulièrement	ADV	particulièrement
pas	ADV	pas
passer	VER:infi	passer
pendant	PRP	pendant
penser	VER:infi	penser
permettre	VER:infi	permettre
personne	ADV	personne
peu	ADV	peu
pff	INT	pff
pfft	NOM	pfft
pfut	NOM	pfut
pif	NOM	pif
pire	ADJ	pire
pièce	NOM	pièce
plein	ADJ	plein
plouf	INT	plouf
plupart	NOM	plupart
plus	ADV	plus
plusieurs	PRO:IND	plusieurs
plutôt	ADV	plutôt
possessif	ADJ	possessif
possible	NOM	possible
pouah	INT	pouah
pour	PRP	pour
pourquoi	ADV	pourquoi
prealable	ADJ	prealable
precisement	NOM	precisement
premier	NOM	premier
premièrement	ADV	premièrement
probable	ADJ	probable
procedant	VER:ppre	procedant
proche	ADV	proche
près	ADV	près
psitt	NOM	psitt
puis	ADV	puis
puisque	KON	puisque
pur	ADJ	pur
quand	KON	quand
quant	PRP	quant
quant-à-soi	NOM	quant-à-soi
quanta	NOM	quanta
quarante	NUM	quarante
quatorze	NUM	quatorze
quatre	NUM	quatre
quatre-vingt	NOM	quatre-vingt
quatrième	NUM	quatrième
quatrièmement	ADV	quatrièmement
que	KON	que
quelconque	ADJ	quelconque
qui	PRO:REL	qui
quiconque	PRO:IND	quiconque
quinze	NOM	quinze
quoi	PRO:REL	quoi
quoique	KON	quoique
rare	ADJ	rare
rarement	ADV	rarement
relatif	ADJ	relatif
relativement	ADV	relativement
remarquable	ADJ	remarquable
rendre	VER:infi	rendre
restant	NOM	restant
rester	VER:infi	rester
restrictif	ADJ	restrictif
retour	NOM	retour
revoici	PRP	revoici
revoilà	ABR	revoilà
rien	NOM	rien
sacrebleu	INT	sacrebleu
savoir	VER:infi	savoir
sans	KON	sans
sapristi	INT	sapristi
sauf	PRP	sauf
sein	NOM	sein
seize	NUM	seize
selon	PRP	selon
semblable	ADJ	semblable
sembler	VER:infi	sembler
sentir	VER:infi	sentir
sept	NUM	sept
septième	NOM	septième
seul	ADJ	seul
seulement	ADV	seulement
si	KON	si
sinon	KON	sinon
six	NUM	six
sixième	NOM	sixième
soi-même	ADJ	soi-même
soixante	NUM	soixante
sous	PRP	sous
souvent	ADV	souvent
specifique	ADJ	specifique
speculatif	ADJ	speculatif
stop	NOM	stop
strictement	ADV	strictement
subtile	ADJ	subtil
suffisant	VER:ppre	suffire
suffire	VER:infi	suffire
suivant	PRP	suivant
suivre	VER:infi	suivre
sujet	NOM	sujet
superposer	VER:infi	superposer
sur	PRP	sur
surtout	ADV	surtout
tac	NOM	tac
tandis	KON	tandis
tant	ADV	tant
tardif	ADJ	tardif
tellement	ADV	tellement
tenant	ADJ	tenant
tente	VER:pres	tenter
tic	NOM	tic
tenir	VER:infi	tenir
toc	NOM	toc
toi-même	PRO:PER	toi-même
touchant	VER:ppre	toucher
toujours	ADV	toujours
tout	ADV	tout
toutefois	ADV	toutefois
treize	NUM	treize
trente	NUM	trente
tres	NOM	tres
trois	NUM	trois
troisième	NOM	troisième
troisièmement	ADV	troisièmement
trop	ADV	trop
très	ADV	très
tsoin	ADJ	tsoin
tsouin	NOM	tsouin
uniformement	NOM	uniformement
unique	ADJ	unique
valeur	NOM	valeur
vers	PRP	vers
via	PRP	via
vif	NOM	vif
vingt	NUM	vingt
vlan	INT	vlan
voici	ADV	voici
voie	NOM	voie
voilà	ADV	voilà
voir	VER:infi	voir
zut	INT	zut
à	PRP	à
â	NOM	â
ça	PRO:DEM	cela
ô	INT	ô
